WWWWWWWWWWWWWWWWWWWWWWWWWWWWWW
WPNNNNNNNNNNNNNNNNNNNNNNNNNNNW
WNNNNNNNNNNNNNNNNNNNNNNNNNNNNW
WNNNNNNNNNNNNNNNNNNNNNNNNNNNNW
WNNNNNNNNNNNNNNNNNNNNNNNNNNNNW
WNNNNNNNNNNNNNNNNNNNNNNNNNNNNW
WNNNNNNNNNWWNNNNNNNNNNNNNNNNNW
WNNNDGHSKNXWNNNNNNNNNNNNNNNNNW
WNNNNNNNNNWWNNNNNNNNNNNNNNNNNW
WNNNNNNNNNNNNNNNNNNNNNNNNNNNNW
WNNNNNNNNNNNNNNNNNNNNNNNNNNNNW
WNNNNNNNNNNNNNNNNNNNNNNNNNNNNW
WNNNNNNNNNNNNNNNNNNNNNNNNNNNNW
WNNNNNNNNNNNNNNNNNNNNNNNNNNNNW
WNNNNNNNNNNNNNNNNNNNNNNNNNNNNW
WNNNNNNNNNNNNNNNNNNNNNNNNNNNNW
WNNNNNNNNNNNNNNNNNNNNNNNNNNNNW
WNNNNNNNNNNNNNNNNNNNNNNNNNNNNW
WNNNNNNNNNNNNNNNNNNNNNNNNNNNNW
WNNNNNNNNNNNNNNNNNNNNNNNNNNNNW
WNNNNNNNNNNNNNNNNNNNNNNNNNNNNW
WNNNNNNNNNNNNNNNNNNNNNNNNNNNNW
WNNNNNNNCNNNNNNNNNNNNNNNNNNNNW
WNNNNNNNNNNNNNNNNNNNNNNNNNNNNW
WNNNNNNNNNNNNNNNNNNNNNNNNNNNNW
WNNNNNNNNNNNNNNNNNNNNNNNNNNNNW
WNNNNNNNNNNNNNNNNNNNNNNNNNNNNW
WNNNNNNNNNNNNNNNNNNNENNNNNNNNW
WNNNNNNNNNNNNNNNNNNNNNNNNNNNNW
WWWWWWWWWWWWWWWWWWWWWWWWWWWWWW
# W=Wall; N=Nothing; E=NormalEnemyTank; C=Cannon; P=Player(Only one); E=Exit; G=Gun(Player); H=HP+1; S=Speed+1; K=Key; D=WeNeedHD
