WWWWWWWWWWWWWWWWWWWWWWWWWWWWWW
PNWNNNNWNNNNNNNNNNNNWNNNNNNNNW
WNWNWWNWNWNNNWWWWWWNWWWWNWWNNW
WNWNNWNWWWNNNNNNNNWNWDNNNWKNNW
WNWNNWNNNWNWWWWWNNWNWWWWWWNNNW
WNNNNWNWNWNNNWNNNNWNWNNNWWWNNW
WWWWNWNWNNNWNWWWWWWNNNWNNNNNNW
WNNNNWNWWWNWNWNNNNNNWWWNWWWWNW
WNWNNNNNNNNWNNNNNNNNNNWNNNNWNW
WNWNWWNNNNNWNWWWWWWNNWWWWWNWNW
WNWNWWWWWWWWNNNNNNWNNNNNNNNWNW
WNWNNNNNNWWWWWNWWWWNNNNNNNNWNW
WNWNNWNWNWNNSWNNNNWNWWWWWWNWWW
WNWWWWNWNWNWWWNWWWWNNNNWNNNNNW
WNNNNWNWNNNWNNNWNWNNNWNWNWWWNW
WWWNNWNWNWNWNWNWNWNWWWNWNNNWNW
WNNNNWNWNWNNNWNWNWNWNNNNNNNWNW
WWWNWWNWWWWWWWNWNWNWWWWWWWNWNW
WNNNNNNNNNNNNNNWNNNWNNNNNNNWNW
WWWWWNNWWWWWNNNWNWWWWWWWNNNWNW
WNNNWNWWWNNNNWWWNNNNNNNWNNNWNW
WNWNNNNHNNWNNNNNNWNNNNNWWWNWNW
WNWWWWWNWWWNWNNNNWNWWWNNNNNWNW
WNNNNNWNNNWNWWWWWWNWNNNNNNNWNW
WWWWWNWNWWWNWNNNNWNWNNWWWWWWWW
WNNNNNNNWNNNWNWWWWNWWWWNNNNNNW
WNNWWWWNWNNNNNNNGWNNNNNNNNNNNW
WNNWNNNNNNNWWWWWWWNWNWWWWWWWWW
WENWNNNNWNNNNNNNNNNWNNNNNNNNNX
WWWWWWWWWWWWWWWWWWWWWWWWWWWWWW
# W=Wall; N=Nothing; E=NormalEnemyTank; C=Cannon; P=Player(Only one); X=Exit; G=Gun(Player); H=HP+1; S=Speed+1; K=Key; D=WeNeedHD
