WWWWWWWWWWWWWWWWWWWWWWWWWWWWWW
WNNNNNNNNNNNNNNNNNNNNNNNNNWNNW
WNNNNNNNNNNNNNNNNNNNNNNNNNWNNW
WNNNNNCNNNNNNNNNNNNNNNNNNNWNNW
WNNWNNNNNNNNNNNNNNNNNNNNNNWNNW
WNNWNNNNNNNNNNNNNNNNNNNNNNWNNW
WNNWNNNNNNNNNNENNNNNNNNNNCWNNW
WNNWNNNNNNNNNNNNNNNNNNNNNNNNNW
WNNWNNNWNNNNNNNNNNNNNNWNNNNNNW
WNNWNNNWNNNNNNNNNNNNNNWNNNNNNW
WNNNNNNWNNNNNNNNNNNNNNWNNNNNNW
WNNNNNNWNNNNWWWWWWNNNNWNNNNNNW
WNNNNNNWNNNNNNNNNNNNNNWNNNNNNW
WNNNNNNWNNNNNNNNNNNNNNWNNNNNNW
WNNNNNNWNNNNNNNNNNNNNNWNNNNNNX
PNNNNNNWENNNNNCNNNNNNEWNNNNNCX
WNNENNNWNNNNNNNNNNNNNNWNNNNNNW
WNNNNNNWNNNNNNNNNNNNNNWNNNNNNW
WNNNNNNWNNNNWWWWWWNNNNWNNNENNW
WNNNNNNWNNNNNNNNNNNNNNWNNNNNNW
WNNWNNNWNNNNNNNNNNNNNNWNNNNNNW
WNNWNNNWNNNNNNNNNNNNNNWNNNNNNW
WNNWNNNNNNNNNNENNNNNNNNNNNNNNW
WNNWNNNNNNNNNNNNNNNNNNNNNNWNNW
WNNWNNNNNNNNNNNNNNNNNNNNNCWNNW
WNNWNNNNNNNNNNNNNNNNNNNNNNWNNW
WNNNNNNNNNNNNNNNNNNNNNNNNNWNNW
WNNNNNCNNNNNNNNNNNNNNNNNNNWNNW
WNNNNNNNNNNNNNNNNNNNNNNNNNWNNW
WWWWWWWWWWWWWWWWWWWWWWWWWWWWWW
# W=Wall; N=Nothing; E=NormalEnemyTank; C=Cannon; P=Player(Only one); X=Exit; G=Gun(Player); H=HP+1; S=Speed+1; K=Key; D=WeNeedHD
